NO ./path_north
SO ./path_south
WE ./path_west
EA ./path_east

F 255,1,255
C 255,0,0

111111
111111
100111
110N01
110101
111111

