NO ./sprites/north_wall.xpm
WE ./sprites/west_wall.xpm
EA ./sprites/east_wall.xpm
SO ./sprites/south_wall.xpm

F 255,1,255
C 255,100,1

 111111
11N011
10001
11111