NO ../../spries/east_wall.xpm
SO ../../sprites/east_wall.xpm
WE ../../sprites/east_wall.xpm
EA ../../sprites/east_wall.xpm

F 255,1,255
C 255,0,0

1111
1N01
1001
1111