NO ./path_north
SO ./path_south
WE ./path_west
EA ./path_east

F 255,1,255
C 255,0,0

1111111
1000001
1000001
1N00011
1111111


