NO ./path
SO ./path
WE ./path
EA ./path

F 255,1,255
C 255,0,0

000000
111111
11N001
110001
110101
111111

