NO ./path
SO ./path
WE ./path
EA ./path

F 255,1,255
C 255,0,0

000000
111111
10N001
100101
110101
111111

